afg: Afghanistan
alb: Albania
arg: Argentina
ast: Australia
aus: Austria
bel: Belgium
bhu: Bhutan
bol: Bolivia
bra: Brazil
bul: Bulgaria
can: Canada
chi: China
chl: Chile
col: Colombia
cos: Costa Rica
cro: Croatia
cub: Cuba
cze: Czechoslovakia
den: Denmark
dom: Dominican Republic
ecu: Ecuador
els: El Salvador
eng: United Kingdom
est: Estonia
eth: Ethiopia
fin: Finland
fra: France
ger: Germany
gre: Greece
gua: Guatemla
gxc: Guangxi
hai: Haiti
hol: Holland
hon: Honduras
hun: Hungary
ire: Ireland
irq: Iraq
ita: Italy
jap: Japan
lat: Latvia
lib: Liberia
lit: Lithuania
lux: Luxemburg
mex: Mexico
mon: Mongolia
nep: Nepal
nic: Nicaragua
nor: Norway
nzl: New Zealand
oma: Oman
pan: Panama
par: Paraguay
per: Persia
phi: Philippines
pol: Poland
por: Portugal
prc: Communist China
pru: Peru
raj: British Raj
rom: Romania
saf: South Africa
sau: Saudi Arabia
shx: Shanxi
sia: Siam
sik: Sinkiang
slo: Slovakia
sov: Soviet Union
spr: Spain
swe: Sweden
swi: Switzerland
tan: Tannu Tuva
tib: Tibet
tur: Turkey
urg: Uruguay
usa: USA
ven: Venezula
xsm: Xibei San Ma
yem: Yemen
yug: Yugoslavia
yun: Yunnan